7 13
1 4 4 2 5 0 4 4 4 4 4 0 6
5 6 1 2 1 2 1 4 0 6 5 0 2
5 0 2 1 2 1 2 3 1 0 6 1 2
1 2 1 2 1 2 1 0 2 1 4 2 3
1 4 2 1 0 6 1 2 1 4 4 0 2
5 4 4 0 4 4 4 2 1 6 1 0 2
4 4 4 4 4 4 4 4 0 4 0 6 3
